0 0 0 0 0 0 0 0 0 0 0 0 0 0 0 0 0 0 0 0 0 0 0 0 0 0 1 1 1 1 1 1
2 2 0 2 2 2 0 2 2 2 0 3 3 3 3 3 3 3 3 3 3 3 3 3 3 3 1 1 1 1 1 1
4 4 0 4 4 4 0 4 4 4 0 12 12 12 12 12 12 12 12 12 12 12 12 12 12 12 1 1 1 1 1 1
5 5 0 5 5 5 0 5 5 5 0 6 6 6 6 6 6 6 6 6 6 6 6 6 6 6 1 1 1 1 1 1
5 5 0 5 5 5 0 5 5 5 0 6 6 6 6 6 6 6 6 6 6 6 6 6 6 6 1 1 1 1 1 1
5 5 2 5 5 5 2 5 5 5 0 6 6 6 6 6 6 6 6 6 6 6 6 6 6 6 1 1 1 1 1 1
5 5 4 5 5 5 4 5 5 5 0 6 6 6 6 6 6 6 6 6 6 6 6 6 6 6 1 1 1 1 1 1
5 5 5 5 5 5 5 5 5 5 0 6 6 6 6 6 6 6 6 6 6 6 6 6 6 6 3 3 7 7 3 3
5 5 5 5 5 5 5 5 5 5 0 6 6 6 6 6 6 6 6 6 6 6 6 6 6 6 3 3 7 7 3 3
5 5 5 5 5 5 5 5 5 5 0 6 6 6 6 6 6 6 6 6 6 6 6 6 6 6 6 6 6 6 6 6
0 0 0 0 5 5 0 0 0 0 0 6 6 6 6 6 6 6 6 6 6 6 6 6 6 6 6 6 6 6 6 6
7 7 7 7 5 5 7 7 7 7 0 6 6 6 6 6 6 6 6 6 6 6 6 6 6 6 6 6 6 6 6 6
8 8 8 8 9 9 8 8 8 8 0 6 6 6 6 6 6 6 6 6 6 6 6 6 6 6 6 6 6 6 6 6
9 9 9 9 9 9 9 9 9 9 0 6 6 6 6 6 6 6 6 6 6 6 6 6 6 6 6 6 6 6 6 6
9 9 9 9 9 9 9 9 9 9 0 0 0 0 0 0 0 0 0 0 0 0 0 0 0 6 6 0 0 0 0 0
9 9 9 9 9 9 9 9 9 9 7 7 7 7 7 7 7 7 7 7 7 7 7 7 7 11 11 7 7 7 7 7
9 9 9 9 9 9 9 9 9 9 8 8 8 8 8 8 8 8 8 8 8 8 8 8 8 9 9 8 8 8 8 8
9 9 9 9 9 9 9 9 9 9 10 9 9 9 9 9 9 9 9 9 9 10 9 9 9 9 9 9 9 9 9 9
9 9 9 9 9 9 9 9 9 9 10 9 9 9 9 9 9 9 9 9 9 10 9 9 9 9 9 9 9 9 9 9
9 9 9 9 9 9 9 9 9 9 10 10 10 9 9 9 9 9 9 10 10 10 9 9 9 9 9 9 9 9 9 9
9 9 9 9 9 9 9 9 9 9 9 9 10 10 10 10 10 10 10 10 9 9 9 9 9 9 9 9 9 9 9 9
9 9 9 9 9 9 9 9 9 9 9 9 9 9 9 9 9 9 9 9 9 9 9 9 9 9 9 9 9 9 9 9
9 9 9 9 9 9 9 9 9 9 9 9 9 9 9 9 9 9 9 9 9 9 9 9 9 9 9 9 9 9 9 9
0 0 0 0 0 0 0 0 0 0 0 0 9 9 9 9 9 9 9 9 0 0 0 0 0 0 0 0 0 0 0 0
7 7 7 7 7 7 7 7 7 7 7 7 9 9 9 9 9 9 9 9 7 7 7 7 7 7 7 7 7 7 7 7
8 8 8 8 8 8 8 8 8 8 8 8 9 9 9 9 9 9 9 9 8 8 8 8 8 8 8 8 8 8 8 8
9 9 9 9 9 9 9 9 9 9 9 9 9 9 9 9 9 9 9 9 9 9 9 9 9 9 9 9 9 9 9 9
9 9 9 9 9 9 9 9 9 9 9 9 9 9 9 9 9 9 9 9 9 9 9 9 9 9 9 9 9 9 9 9
9 9 9 9 9 9 9 9 9 9 9 9 9 9 9 9 9 9 9 9 9 9 9 9 9 9 9 9 9 9 9 9
9 9 9 9 9 9 9 9 9 9 9 9 9 9 9 9 9 9 9 9 9 9 9 9 9 9 9 9 9 9 9 9
9 9 9 9 9 9 9 9 9 9 9 9 9 9 9 9 9 9 9 9 9 9 9 9 9 9 9 9 9 9 9 9
9 9 9 9 9 9 9 9 9 9 9 9 9 9 9 9 9 9 9 9 9 9 9 9 9 9 9 9 9 9 9 9